000000000000000000000000000000000000000000000
000000000000000000000000000000000000000000000
000000000000000000000444440000000000000000000
444000004440000000000444440000000000000000444
000000000000000000000444440000000000000000000
000000000000000000000000000000000000000000000
000000000000000000000000000000000000000000000
000000000000000000000000000000000000000000000
000004444000444004444440444444044000044444000
000004004404000400044000004400044000044000000
000004444004444400044000004400044000044440000
000004004404000400044000004400044000044000000
000004444004000400044000004400044444044444000
000000000000000000000000000000000000000000000
000000000000000000000000000000000000000000000
000000000000000000000000000000000000000000000
000000000000444400444444044444404000400000000
000000000004400440004400000440004404400000000
000000000004400000004400000440000444000000000
000000000004400440004400000440000040000000000
000000000000444400444444000440000040000000000
444400000000000000000000000000000000000004444
444400000000000000000000000000000000000004444
444400000000000000000000000000000000000004444
444444400000000000000000000000000000004444444
444444400000000000000000000000000000004444444
444444400000000000000000000000000000004444444
444444444440000000444444444000000044444444444
444444444440000000444444444000000044444444444
444444444444440000444500444000044444444444444
444444444444440010444000444000044444444444444
444444444444440000444000444000044444444444444
