111111111111111111111111111111111111111111111
111111111111111111111111111111111111111111111
111111111111111111111555551111111111111111111
555111115551111111111555551111111111111111555
111111111111111111111555551111111111111111111
111111111111111111111111111111111111111111111
111111111111111111111111111111111111111111111
111111111111111111111111111111111111111111111
111115555111555115555551555555155111155555111
111115115515111511155111115511155111155111111
111115555115555511155111115511155111155551111
111115115515111511155111115511155111155111111
111115555115111511155111115511155555155555111
111111111111111111111111111111111111111111111
111111111111111111111111111111111111111111111
111111111111111111111111111111111111111111111
111111111111555511555555155555515111511111111
111111111115511551115511111551115515511111111
111111111115511111115511111551111555111111111
111111111115511551115511111551111151111111111
111111111111555511555555111551111151111111111
555511111111111111111111111111111111111115555
555511111111111111111111111111111111111115555
555511111111111111111111111111111111111115555
555555511111111111111111111111111111115555555
555555511111111111111111111111111111115555555
555555511111111111111111111111111111115555555
555555555551111111555555555111111155555555555
555555555551111111555555555111111155555555555
555555555555551111555611555111155555555555555
555555555555551121555111555111155555555555555
555555555555551111555111555111155555555555555
