000000000000000000000000000000000000000000000
000000000000000000000000000000000000000000000
000000000000000000000111110000000000000000000
111000001110000000000111110000000000000000111
000000000000000000000111110000000000000000000
000000000000000000000000000000000000000000000
000000000000000000000000000000000000000000000
000000000000000000000000000000000000000000000
000001111000111001111110111111011000011111000
000001001101000100011000001100011000011000000
000001111001111100011000001100011000011110000
000001001101000100011000001100011000011000000
000001111001000100011000001100011111011111000
000000000000000000000000000000000000000000000
000000000000000000000000000000000000000000000
000000000000000000000000000000000000000000000
000000000000111100111111011111101000100000000
000000000001100110001100000110001101100000000
000000000001100000001100000110000111000000000
000000000001100110001100000110000010000000000
000000000000111100111111000110000010000000000
111100000000000000000000000000000000000001111
111100000000000000000000000000000000000001111
111100000000000000000000000000000000000001111
111111100000000000000000000000000000001111111
111111100000000000000000000000000000001111111
111111100000000000000000000000000000001111111
111111111110000000111111111000000011111111111
111111111110000000111111111000000011111111111
111111111111110000111000111000011111111111111
111111111111110000111000111000011111111111111
111111111111110000111000111000011111111111111
