000000000000000000000000000000000000000000000
000000000000000000000000000000000000000000000
000444400044440004444000444400044440004444000
000444400044440004444000444400044440004444000
000444400044440004444000444400044440004444000
000444400044440004444000444400044440004444000
000444400044440004444000444400044440004444000
000444400044440004444444444400044440004444000
000444400044440004444444444400044440004444000
000444400044440004444444444400044440004444000
000444400044440004444000444400044440004444000
000444400044440000000000000000044440004444000
000444400044440000000000000000044440004444000
000444400044440004444000444400044440004444000
000000000000000004444000444400000000000000000
000000000000000004444000444400000000000000000
444400044444440000000000000000044444440004444
444400044444440000000000000000044444440004444
444400044444440004444000444400044444440004444
000000000000000004444444444400000000000000000
000000000000000004444444444400000000000000000
000444400044440004444444444400044440004444000
000444400044440004444000444400044440004444000
000444400044440004444000444400044440004444000
000444400044440004444000444400044440004444000
000444400044440000000000000000044440004444000
000444400044440000000000000000044440004444000
000444400044440000044444440000044440004444000
000444400044440000044444440000044440004444000
000444400044440000044500440000044440004444000
000000000000000001044000440000000000000000000
000000000000000000044000440000000000000000000