111191111111111111111111111111111911111111111
111111111111111111111111111111111111111111111
111555511155551115555111555511155551115555111
111555511155551115555111555511155551115555111
111555511155551115555111555511155551115555111
111555511155551115555111555511155551115555111
111555511155551115555111555511155551115555111
111555511155551115555555555511155551115555111
111555511155551115555555555511155551115555111
111555511155551115555555555511155551115555111
111555511155551115555111555511155551115555111
111555511155551111111111111111155551115555111
111555511155551111111111111111155551115555111
111555511155551115555111555511155551115555111
111111111111111115555111555511111111111111111
111111111111111115555111555511111111111111111
555511155555551111111111111111155555551115555
555511155555551111111111111111155555551115555
555511155555551115555111555511155555551115555
111111111111111115555555555511111111111111111
111111111111111115555555555511111111111111111
111555511155551115555555555511155551115555111
111555511155551115555111555511155551115555111
111555511155551115555111555511155551115555111
111555511155551115555111555511155551115555111
111555511155551111111111111111155551115555111
111555511155551111111111111111155551115555111
111555511155551111155555551111155551115555111
111555511155551111155555551111155551115555111
111555511155551121155611551111155551115555111
111111111111111111155111551111111111111111111
111111111111111111155111551111111111111111111